1744713646
1744896842
1745060050
1745269662
1745625477
1745665871
1745700256
1745864651
1746034048
1746300393
1746600207
1747473741
1749900299
1751195307
1752310879
1759868176
1765104740